{
  "name": "Kaladesh Remastered Arena Booster",
  "code": "klr-arena",
  "set_code": "klr",
  "set_name": "Kaladesh Remastered",
  "boosters": [
    {
      "sheets": {
        "common": 10,
        "uncommon": 3,
        "rare_mythic": 1
      },
      "weight": 1
    }
  ],
  "sheets": {
    "common": {
      "balance_colors": true,
      "total_weight": 104,
      "cards": {
        "klr:10": 1,
        "klr:101": 1,
        "klr:102": 1,
        "klr:103": 1,
        "klr:105": 1,
        "klr:107": 1,
        "klr:11": 1,
        "klr:113": 1,
        "klr:115": 1,
        "klr:116": 1,
        "klr:118": 1,
        "klr:119": 1,
        "klr:121": 1,
        "klr:125": 1,
        "klr:128": 1,
        "klr:13": 1,
        "klr:135": 1,
        "klr:137": 1,
        "klr:14": 1,
        "klr:141": 1,
        "klr:142": 1,
        "klr:143": 1,
        "klr:148": 1,
        "klr:149": 1,
        "klr:15": 1,
        "klr:150": 1,
        "klr:151": 1,
        "klr:154": 1,
        "klr:157": 1,
        "klr:159": 1,
        "klr:16": 1,
        "klr:162": 1,
        "klr:163": 1,
        "klr:164": 1,
        "klr:165": 1,
        "klr:166": 1,
        "klr:173": 1,
        "klr:176": 1,
        "klr:178": 1,
        "klr:18": 1,
        "klr:181": 1,
        "klr:183": 1,
        "klr:184": 1,
        "klr:186": 1,
        "klr:21": 1,
        "klr:22": 1,
        "klr:223": 1,
        "klr:227": 1,
        "klr:228": 1,
        "klr:229": 1,
        "klr:23": 1,
        "klr:234": 1,
        "klr:236": 1,
        "klr:24": 1,
        "klr:240": 1,
        "klr:244": 1,
        "klr:245": 1,
        "klr:246": 1,
        "klr:247": 1,
        "klr:253": 1,
        "klr:254": 1,
        "klr:26": 1,
        "klr:261": 1,
        "klr:263": 1,
        "klr:264": 1,
        "klr:265": 1,
        "klr:266": 1,
        "klr:269": 1,
        "klr:271": 1,
        "klr:273": 1,
        "klr:275": 1,
        "klr:277": 1,
        "klr:278": 1,
        "klr:29": 1,
        "klr:3": 1,
        "klr:39": 1,
        "klr:40": 1,
        "klr:41": 1,
        "klr:48": 1,
        "klr:51": 1,
        "klr:52": 1,
        "klr:54": 1,
        "klr:55": 1,
        "klr:56": 1,
        "klr:59": 1,
        "klr:6": 1,
        "klr:62": 1,
        "klr:63": 1,
        "klr:65": 1,
        "klr:68": 1,
        "klr:69": 1,
        "klr:72": 1,
        "klr:75": 1,
        "klr:77": 1,
        "klr:78": 1,
        "klr:79": 1,
        "klr:8": 1,
        "klr:81": 1,
        "klr:85": 1,
        "klr:86": 1,
        "klr:88": 1,
        "klr:89": 1,
        "klr:95": 1,
        "klr:99": 1
      }
    },
    "uncommon": {
      "total_weight": 97,
      "cards": {
        "klr:1": 1,
        "klr:106": 1,
        "klr:108": 1,
        "klr:109": 1,
        "klr:110": 1,
        "klr:114": 1,
        "klr:122": 1,
        "klr:126": 1,
        "klr:127": 1,
        "klr:129": 1,
        "klr:131": 1,
        "klr:132": 1,
        "klr:138": 1,
        "klr:140": 1,
        "klr:144": 1,
        "klr:145": 1,
        "klr:147": 1,
        "klr:152": 1,
        "klr:153": 1,
        "klr:155": 1,
        "klr:158": 1,
        "klr:167": 1,
        "klr:168": 1,
        "klr:169": 1,
        "klr:17": 1,
        "klr:170": 1,
        "klr:171": 1,
        "klr:175": 1,
        "klr:177": 1,
        "klr:182": 1,
        "klr:189": 1,
        "klr:190": 1,
        "klr:194": 1,
        "klr:195": 1,
        "klr:196": 1,
        "klr:197": 1,
        "klr:199": 1,
        "klr:2": 1,
        "klr:20": 1,
        "klr:201": 1,
        "klr:203": 1,
        "klr:204": 1,
        "klr:205": 1,
        "klr:206": 1,
        "klr:208": 1,
        "klr:210": 1,
        "klr:211": 1,
        "klr:212": 1,
        "klr:213": 1,
        "klr:214": 1,
        "klr:215": 1,
        "klr:216": 1,
        "klr:221": 1,
        "klr:222": 1,
        "klr:224": 1,
        "klr:226": 1,
        "klr:231": 1,
        "klr:232": 1,
        "klr:233": 1,
        "klr:238": 1,
        "klr:239": 1,
        "klr:241": 1,
        "klr:255": 1,
        "klr:256": 1,
        "klr:257": 1,
        "klr:27": 1,
        "klr:270": 1,
        "klr:274": 1,
        "klr:276": 1,
        "klr:279": 1,
        "klr:28": 1,
        "klr:30": 1,
        "klr:31": 1,
        "klr:34": 1,
        "klr:36": 1,
        "klr:37": 1,
        "klr:38": 1,
        "klr:44": 1,
        "klr:47": 1,
        "klr:49": 1,
        "klr:5": 1,
        "klr:50": 1,
        "klr:53": 1,
        "klr:58": 1,
        "klr:64": 1,
        "klr:66": 1,
        "klr:67": 1,
        "klr:71": 1,
        "klr:74": 1,
        "klr:76": 1,
        "klr:82": 1,
        "klr:83": 1,
        "klr:84": 1,
        "klr:87": 1,
        "klr:90": 1,
        "klr:91": 1,
        "klr:97": 1
      }
    },
    "rare_mythic": {
      "total_weight": 148,
      "cards": {
        "klr:100": 2,
        "klr:104": 1,
        "klr:111": 2,
        "klr:112": 2,
        "klr:117": 1,
        "klr:12": 1,
        "klr:120": 1,
        "klr:123": 2,
        "klr:124": 2,
        "klr:130": 1,
        "klr:133": 2,
        "klr:134": 2,
        "klr:136": 2,
        "klr:139": 2,
        "klr:146": 2,
        "klr:156": 2,
        "klr:160": 2,
        "klr:161": 2,
        "klr:172": 1,
        "klr:174": 2,
        "klr:179": 2,
        "klr:180": 2,
        "klr:185": 1,
        "klr:187": 2,
        "klr:188": 1,
        "klr:19": 2,
        "klr:191": 2,
        "klr:192": 2,
        "klr:193": 1,
        "klr:198": 2,
        "klr:200": 2,
        "klr:202": 1,
        "klr:207": 1,
        "klr:209": 1,
        "klr:217": 2,
        "klr:218": 2,
        "klr:219": 1,
        "klr:220": 2,
        "klr:225": 2,
        "klr:230": 2,
        "klr:235": 2,
        "klr:237": 2,
        "klr:242": 1,
        "klr:243": 2,
        "klr:248": 2,
        "klr:249": 2,
        "klr:25": 2,
        "klr:250": 2,
        "klr:251": 2,
        "klr:252": 2,
        "klr:258": 2,
        "klr:259": 1,
        "klr:260": 2,
        "klr:262": 1,
        "klr:267": 2,
        "klr:268": 2,
        "klr:272": 1,
        "klr:280": 2,
        "klr:281": 2,
        "klr:282": 2,
        "klr:283": 2,
        "klr:284": 2,
        "klr:285": 2,
        "klr:286": 2,
        "klr:32": 2,
        "klr:33": 2,
        "klr:35": 2,
        "klr:4": 2,
        "klr:42": 2,
        "klr:43": 2,
        "klr:45": 2,
        "klr:46": 2,
        "klr:57": 1,
        "klr:60": 2,
        "klr:61": 2,
        "klr:7": 1,
        "klr:70": 1,
        "klr:73": 2,
        "klr:80": 1,
        "klr:9": 2,
        "klr:92": 2,
        "klr:93": 2,
        "klr:94": 1,
        "klr:96": 2,
        "klr:98": 2
      }
    }
  },
  "source_set_codes": [
    "klr"
  ]
}